NO ./textures/cobblestone.xpm42
SO ./textures/cobblestone.xpm42
WE ./textures/cobblestone.xpm42
EA ./textures/cobblestone.xpm42
F 255,0,34
C 255,255,0
        1111111111111111111111111
        100000000011000000000000111111
        101100000111000000000100000001
        100100000000000000100000111111
111111111011000001110000010000001
10000000001100000111000E000111111
11110111111111011100100000001
11110111111111011100100000001
11000000110101011100000000001
10000000000000001100000000001
10000000000000001100010010001
11000001110101011111011110001
11110111 1110101 101111010001
11111111 1111111 111111111111