NO ./textures/greystone.xpm42
SO ./textures/mossy.xpm42
WE ./textures/eagle.xpm42
EA ./textures/wood.xpm42
F 255,255,250
C 255,255,255
        1111111111111111111111111
        1000000000110000000000001
        1011000001110000000000001
        1001000000000000000000001
111111111011000001110000000000001
10000000001100000111000S000111111
11110111111111011100000000001
11110111111111011101000000001
11000000110101011100000000001
10000000000000001100000000001
10000000000000001101010010001
1100000111010101111101111000111
11110111 1110101 101111010001
11111111 1111111 111111111111