NO ./textures/greystone.xpm42
SO ./textures/mossy.xpm42
WE ./textures/eagle.xpm42
EA ./textures/wood.xpm42
F 255,255,0
C 255,255,250
        1111111111111111111111111
        100000000011000000000000111111
        101100000111000000000100000001
        100100000000100000100000111111
111111111011000001110000010000001
10000000001100000111000S000111111
11110111111111011100100000001
11110111111111011100100000001
11000000110101011100000000001
10000000000000001100000000001
10000000000000001100010010001
1100000111010101111101111000111
11110111 1110101 101111010001
11111111 1111111 111111111111