NO ./textures/greystone.xpm
SO ./textures/mossy.xpm
EA ./textures/wood.xpm
WE ./textures/eagle.xpm
C 255,255,255
F 255,255,250

  111111111111111111111111
 100000000011000001100000011
110100S00111000001  101000011
 10010000001111100110000001
  111111111    11111111111