NO ./textures/greystone.xpm42
SO ./textures/mossy.xpm42
WE ./textures/eagle.xpm42
EA ./textures/wood.xpm42
F 255,255,250
C 255,255,255
1111111111111
1000000000001
1000000000001
1000000000001
1000000000001
100000S000001
1001000000001
1111111111111