NO ./textures/greystone.png
SO ./textures/mossy.png
EA ./textures/wood.png
WE ./textures/eagle.png
C 255,255,255
F 255,255,250

   11111111111111111111111
1110000000011000001100000011
100100S00111000001 101000001
 100100000011111001100000001
  111111111    111111111111