NO ./textures/greystone.xpm42
SO ./textures/mossy.xpm42
EA ./textures/wood.xpm42
WE ./textures/eagle.xpm42
C 255,255,255
F 255,255,250

 1111111111111111111111111
1110000000011000001100000011
100100S00111000001 101000001
 100100000011111001100000001
  111111111    111111111111