NO ./textures/colors/color1.png
SO ./textures/colors/color2.png
EA ./textures/colors/color3.png
WE ./textures/colors/color4.png
C 255,0,255
F 255,255,0

1111111111111111111111111111111111
1000000000000000000000000000000001
1000000000000000000000000000000001
1000000000001110000001111111100001
1000000000111000000111000011100001
1000000011101110000000001110000001
1000001110011100000001110000000001
1000111111111110001110000000000001
1000000001110000111000000000000001
1000000001110001111111111000000001
1000000000000000000000000000000001
10000000000000000N0000000000000001
1111111111111111111111111111111111